,kabupaten/kota,jenis_kekerasan,jumlah_korban_anak_laki-laki,jumlah_korban_anak_perempuan,jumlah_korban_perempuan,total_korban,tahun
0,kabupaten bogor,eksploitasi,0,0,0,0,2017
1,kabupaten bogor,fisik,0,0,1,1,2017
2,kabupaten bogor,lainnya,0,0,0,0,2017
3,kabupaten bogor,penelantaran,0,0,0,0,2017
4,kabupaten bogor,psikis,0,0,0,0,2017
5,kabupaten bogor,seksual,0,0,0,0,2017
6,kabupaten bogor,trafficking,0,0,0,0,2017
7,kabupaten sukabumi,eksploitasi,0,0,0,0,2017
8,kabupaten sukabumi,fisik,1,1,1,3,2017
9,kabupaten sukabumi,lainnya,0,0,0,0,2017
10,kabupaten sukabumi,penelantaran,0,0,1,1,2017
11,kabupaten sukabumi,psikis,1,0,1,2,2017
12,kabupaten sukabumi,seksual,0,1,0,1,2017
13,kabupaten sukabumi,trafficking,0,0,0,0,2017
14,kabupaten cianjur,eksploitasi,0,0,0,0,2017
15,kabupaten cianjur,fisik,0,1,0,1,2017
16,kabupaten cianjur,lainnya,0,0,0,0,2017
17,kabupaten cianjur,penelantaran,0,0,0,0,2017
18,kabupaten cianjur,psikis,1,0,0,1,2017
19,kabupaten cianjur,seksual,0,1,0,1,2017
20,kabupaten cianjur,trafficking,0,0,0,0,2017
21,kabupaten bandung,eksploitasi,0,2,1,3,2017
22,kabupaten bandung,fisik,3,15,17,35,2017
23,kabupaten bandung,lainnya,5,1,2,8,2017
24,kabupaten bandung,penelantaran,4,10,2,16,2017
25,kabupaten bandung,psikis,1,9,5,15,2017
26,kabupaten bandung,seksual,18,41,10,69,2017
27,kabupaten bandung,trafficking,0,3,5,8,2017
28,kabupaten garut,eksploitasi,0,0,0,0,2017
29,kabupaten garut,fisik,0,0,1,1,2017
30,kabupaten garut,lainnya,0,0,0,0,2017
31,kabupaten garut,penelantaran,0,0,1,1,2017
32,kabupaten garut,psikis,0,0,0,0,2017
33,kabupaten garut,seksual,0,11,0,11,2017
34,kabupaten garut,trafficking,0,0,0,0,2017
35,kabupaten tasikmalaya,eksploitasi,1,0,0,1,2017
36,kabupaten tasikmalaya,fisik,1,2,6,9,2017
37,kabupaten tasikmalaya,lainnya,1,1,2,4,2017
38,kabupaten tasikmalaya,penelantaran,0,0,11,11,2017
39,kabupaten tasikmalaya,psikis,0,1,3,4,2017
40,kabupaten tasikmalaya,seksual,3,40,2,45,2017
41,kabupaten tasikmalaya,trafficking,0,3,2,5,2017
42,kabupaten ciamis,eksploitasi,0,0,0,0,2017
43,kabupaten ciamis,fisik,6,0,6,12,2017
44,kabupaten ciamis,lainnya,0,1,2,3,2017
45,kabupaten ciamis,penelantaran,0,0,0,0,2017
46,kabupaten ciamis,psikis,0,0,1,1,2017
47,kabupaten ciamis,seksual,0,16,2,18,2017
48,kabupaten ciamis,trafficking,0,0,0,0,2017
49,kabupaten kuningan,eksploitasi,0,0,0,0,2017
50,kabupaten kuningan,fisik,0,0,0,0,2017
51,kabupaten kuningan,lainnya,0,0,0,0,2017
52,kabupaten kuningan,penelantaran,0,0,1,1,2017
53,kabupaten kuningan,psikis,0,0,1,1,2017
54,kabupaten kuningan,seksual,0,1,2,3,2017
55,kabupaten kuningan,trafficking,0,0,0,0,2017
56,kabupaten cirebon,eksploitasi,0,0,0,0,2017
57,kabupaten cirebon,fisik,0,0,0,0,2017
58,kabupaten cirebon,lainnya,0,0,0,0,2017
59,kabupaten cirebon,penelantaran,0,0,0,0,2017
60,kabupaten cirebon,psikis,0,0,0,0,2017
61,kabupaten cirebon,seksual,1,6,0,7,2017
62,kabupaten cirebon,trafficking,0,0,0,0,2017
63,kabupaten majalengka,eksploitasi,0,0,0,0,2017
64,kabupaten majalengka,fisik,0,0,1,1,2017
65,kabupaten majalengka,lainnya,0,0,0,0,2017
66,kabupaten majalengka,penelantaran,0,0,0,0,2017
67,kabupaten majalengka,psikis,0,0,0,0,2017
68,kabupaten majalengka,seksual,0,2,0,2,2017
69,kabupaten majalengka,trafficking,0,0,0,0,2017
70,kabupaten sumedang,eksploitasi,0,0,0,0,2017
71,kabupaten sumedang,fisik,3,3,6,12,2017
72,kabupaten sumedang,lainnya,0,0,0,0,2017
73,kabupaten sumedang,penelantaran,0,2,0,2,2017
74,kabupaten sumedang,psikis,0,1,0,1,2017
75,kabupaten sumedang,seksual,1,9,1,11,2017
76,kabupaten sumedang,trafficking,0,0,0,0,2017
77,kabupaten indramayu,eksploitasi,0,0,0,0,2017
78,kabupaten indramayu,fisik,0,0,4,4,2017
79,kabupaten indramayu,lainnya,0,0,0,0,2017
80,kabupaten indramayu,penelantaran,0,0,0,0,2017
81,kabupaten indramayu,psikis,0,0,2,2,2017
82,kabupaten indramayu,seksual,0,0,0,0,2017
83,kabupaten indramayu,trafficking,0,0,0,0,2017
84,kabupaten subang,eksploitasi,0,0,0,0,2017
85,kabupaten subang,fisik,1,0,0,1,2017
86,kabupaten subang,lainnya,0,0,0,0,2017
87,kabupaten subang,penelantaran,0,0,0,0,2017
88,kabupaten subang,psikis,0,0,0,0,2017
89,kabupaten subang,seksual,0,5,0,5,2017
90,kabupaten subang,trafficking,0,0,2,2,2017
91,kabupaten purwakarta,eksploitasi,0,0,0,0,2017
92,kabupaten purwakarta,fisik,0,1,0,1,2017
93,kabupaten purwakarta,lainnya,0,0,0,0,2017
94,kabupaten purwakarta,penelantaran,0,0,0,0,2017
95,kabupaten purwakarta,psikis,0,0,0,0,2017
96,kabupaten purwakarta,seksual,1,0,0,1,2017
97,kabupaten purwakarta,trafficking,0,0,0,0,2017
98,kabupaten karawang,eksploitasi,0,0,0,0,2017
99,kabupaten karawang,fisik,0,0,1,1,2017
100,kabupaten karawang,lainnya,0,0,0,0,2017
101,kabupaten karawang,penelantaran,0,0,0,0,2017
102,kabupaten karawang,psikis,0,0,0,0,2017
103,kabupaten karawang,seksual,5,0,0,5,2017
104,kabupaten karawang,trafficking,0,0,0,0,2017
105,kabupaten bekasi,eksploitasi,0,0,0,0,2017
106,kabupaten bekasi,fisik,0,1,0,1,2017
107,kabupaten bekasi,lainnya,0,0,0,0,2017
108,kabupaten bekasi,penelantaran,0,0,1,1,2017
109,kabupaten bekasi,psikis,0,1,0,1,2017
110,kabupaten bekasi,seksual,0,1,0,1,2017
111,kabupaten bekasi,trafficking,0,0,0,0,2017
112,kabupaten bandung barat,eksploitasi,0,0,0,0,2017
113,kabupaten bandung barat,fisik,0,0,0,0,2017
114,kabupaten bandung barat,lainnya,0,0,0,0,2017
115,kabupaten bandung barat,penelantaran,1,1,0,2,2017
116,kabupaten bandung barat,psikis,0,0,0,0,2017
117,kabupaten bandung barat,seksual,0,0,0,0,2017
118,kabupaten bandung barat,trafficking,0,0,0,0,2017
119,kabupaten pangandaran,eksploitasi,0,0,0,0,2017
120,kabupaten pangandaran,fisik,0,0,0,0,2017
121,kabupaten pangandaran,lainnya,0,1,0,1,2017
122,kabupaten pangandaran,penelantaran,0,0,0,0,2017
123,kabupaten pangandaran,psikis,0,0,0,0,2017
124,kabupaten pangandaran,seksual,2,21,0,23,2017
125,kabupaten pangandaran,trafficking,0,0,0,0,2017
126,kota bogor,eksploitasi,0,0,0,0,2017
127,kota bogor,fisik,0,1,0,1,2017
128,kota bogor,lainnya,0,0,0,0,2017
129,kota bogor,penelantaran,0,0,0,0,2017
130,kota bogor,psikis,0,0,0,0,2017
131,kota bogor,seksual,1,1,0,2,2017
132,kota bogor,trafficking,0,0,0,0,2017
133,kota sukabumi,eksploitasi,0,0,0,0,2017
134,kota sukabumi,fisik,0,0,1,1,2017
135,kota sukabumi,lainnya,0,0,0,0,2017
136,kota sukabumi,penelantaran,0,0,0,0,2017
137,kota sukabumi,psikis,0,1,0,1,2017
138,kota sukabumi,seksual,0,2,0,2,2017
139,kota sukabumi,trafficking,0,0,0,0,2017
140,kota bandung,eksploitasi,0,0,0,0,2017
141,kota bandung,fisik,2,7,13,22,2017
142,kota bandung,lainnya,4,3,8,15,2017
143,kota bandung,penelantaran,2,0,4,6,2017
144,kota bandung,psikis,3,5,19,27,2017
145,kota bandung,seksual,0,6,2,8,2017
146,kota bandung,trafficking,2,0,3,5,2017
147,kota cirebon,eksploitasi,0,0,0,0,2017
148,kota cirebon,fisik,0,1,2,3,2017
149,kota cirebon,lainnya,0,1,0,1,2017
150,kota cirebon,penelantaran,0,0,0,0,2017
151,kota cirebon,psikis,0,1,1,2,2017
152,kota cirebon,seksual,0,3,0,3,2017
153,kota cirebon,trafficking,0,0,0,0,2017
154,kota bekasi,eksploitasi,0,0,0,0,2017
155,kota bekasi,fisik,0,0,0,0,2017
156,kota bekasi,lainnya,0,0,0,0,2017
157,kota bekasi,penelantaran,1,0,2,3,2017
158,kota bekasi,psikis,1,0,1,2,2017
159,kota bekasi,seksual,0,0,0,0,2017
160,kota bekasi,trafficking,0,0,0,0,2017
161,kota depok,eksploitasi,0,0,0,0,2017
162,kota depok,fisik,0,0,1,1,2017
163,kota depok,lainnya,0,0,0,0,2017
164,kota depok,penelantaran,0,0,1,1,2017
165,kota depok,psikis,0,0,1,1,2017
166,kota depok,seksual,0,0,0,0,2017
167,kota depok,trafficking,0,0,0,0,2017
168,kota cimahi,eksploitasi,0,0,0,0,2017
169,kota cimahi,fisik,0,0,1,1,2017
170,kota cimahi,lainnya,0,0,0,0,2017
171,kota cimahi,penelantaran,0,0,0,0,2017
172,kota cimahi,psikis,0,0,1,1,2017
173,kota cimahi,seksual,0,0,0,0,2017
174,kota cimahi,trafficking,0,0,0,0,2017
175,kota tasikmalaya,eksploitasi,0,2,0,2,2017
176,kota tasikmalaya,fisik,3,4,1,8,2017
177,kota tasikmalaya,lainnya,0,0,1,1,2017
178,kota tasikmalaya,penelantaran,0,0,0,0,2017
179,kota tasikmalaya,psikis,0,1,1,2,2017
180,kota tasikmalaya,seksual,1,9,0,10,2017
181,kota tasikmalaya,trafficking,0,3,1,4,2017
182,kota banjar,eksploitasi,0,0,0,0,2017
183,kota banjar,fisik,0,0,0,0,2017
184,kota banjar,lainnya,0,0,0,0,2017
185,kota banjar,penelantaran,0,0,0,0,2017
186,kota banjar,psikis,0,0,0,0,2017
187,kota banjar,seksual,0,2,0,2,2017
188,kota banjar,trafficking,0,0,0,0,2017
189,kabupaten bogor,eksploitasi,0,0,0,0,2018
190,kabupaten bogor,fisik,0,1,0,1,2018
191,kabupaten bogor,lainnya,0,0,0,0,2018
192,kabupaten bogor,penelantaran,0,1,0,1,2018
193,kabupaten bogor,psikis,0,1,0,1,2018
194,kabupaten bogor,seksual,0,0,0,0,2018
195,kabupaten bogor,trafficking,0,0,0,0,2018
196,kabupaten sukabumi,eksploitasi,0,0,0,0,2018
197,kabupaten sukabumi,fisik,0,0,0,0,2018
198,kabupaten sukabumi,lainnya,0,2,0,2,2018
199,kabupaten sukabumi,penelantaran,0,0,0,0,2018
200,kabupaten sukabumi,psikis,1,1,0,2,2018
201,kabupaten sukabumi,seksual,12,48,0,60,2018
202,kabupaten sukabumi,trafficking,0,2,0,2,2018
203,kabupaten cianjur,eksploitasi,0,0,0,0,2018
204,kabupaten cianjur,fisik,0,0,0,0,2018
205,kabupaten cianjur,lainnya,0,1,0,1,2018
206,kabupaten cianjur,penelantaran,0,0,0,0,2018
207,kabupaten cianjur,psikis,0,0,0,0,2018
208,kabupaten cianjur,seksual,4,1,0,5,2018
209,kabupaten cianjur,trafficking,0,0,0,0,2018
210,kabupaten bandung,eksploitasi,0,3,0,3,2018
211,kabupaten bandung,fisik,1,6,2,9,2018
212,kabupaten bandung,lainnya,0,0,0,0,2018
213,kabupaten bandung,penelantaran,0,2,0,2,2018
214,kabupaten bandung,psikis,5,3,0,8,2018
215,kabupaten bandung,seksual,3,36,0,39,2018
216,kabupaten bandung,trafficking,0,0,1,1,2018
217,kabupaten garut,eksploitasi,0,0,0,0,2018
218,kabupaten garut,fisik,2,1,0,3,2018
219,kabupaten garut,lainnya,0,1,0,1,2018
220,kabupaten garut,penelantaran,2,2,0,4,2018
221,kabupaten garut,psikis,5,8,0,13,2018
222,kabupaten garut,seksual,2,5,0,7,2018
223,kabupaten garut,trafficking,0,0,0,0,2018
224,kabupaten tasikmalaya,eksploitasi,0,0,0,0,2018
225,kabupaten tasikmalaya,fisik,1,4,3,8,2018
226,kabupaten tasikmalaya,lainnya,0,4,5,9,2018
227,kabupaten tasikmalaya,penelantaran,1,0,1,2,2018
228,kabupaten tasikmalaya,psikis,0,1,3,4,2018
229,kabupaten tasikmalaya,seksual,10,11,3,24,2018
230,kabupaten tasikmalaya,trafficking,0,0,0,0,2018
231,kabupaten ciamis,eksploitasi,0,0,0,0,2018
232,kabupaten ciamis,fisik,0,1,4,5,2018
233,kabupaten ciamis,lainnya,0,0,0,0,2018
234,kabupaten ciamis,penelantaran,0,2,0,2,2018
235,kabupaten ciamis,psikis,0,2,1,3,2018
236,kabupaten ciamis,seksual,0,0,0,0,2018
237,kabupaten ciamis,trafficking,0,0,0,0,2018
238,kabupaten kuningan,eksploitasi,0,0,0,0,2018
239,kabupaten kuningan,fisik,0,0,1,1,2018
240,kabupaten kuningan,lainnya,0,0,0,0,2018
241,kabupaten kuningan,penelantaran,0,0,0,0,2018
242,kabupaten kuningan,psikis,0,0,1,1,2018
243,kabupaten kuningan,seksual,5,12,0,17,2018
244,kabupaten kuningan,trafficking,0,0,0,0,2018
245,kabupaten cirebon,eksploitasi,0,0,0,0,2018
246,kabupaten cirebon,fisik,4,2,13,19,2018
247,kabupaten cirebon,lainnya,0,8,0,8,2018
248,kabupaten cirebon,penelantaran,0,0,0,0,2018
249,kabupaten cirebon,psikis,1,1,3,5,2018
250,kabupaten cirebon,seksual,0,16,0,16,2018
251,kabupaten cirebon,trafficking,0,0,1,1,2018
252,kabupaten majalengka,eksploitasi,0,0,0,0,2018
253,kabupaten majalengka,fisik,1,0,0,1,2018
254,kabupaten majalengka,lainnya,0,0,0,0,2018
255,kabupaten majalengka,penelantaran,0,1,0,1,2018
256,kabupaten majalengka,psikis,0,1,0,1,2018
257,kabupaten majalengka,seksual,3,13,0,16,2018
258,kabupaten majalengka,trafficking,0,0,1,1,2018
259,kabupaten sumedang,eksploitasi,0,0,0,0,2018
260,kabupaten sumedang,fisik,4,11,0,15,2018
261,kabupaten sumedang,lainnya,0,0,0,0,2018
262,kabupaten sumedang,penelantaran,0,0,0,0,2018
263,kabupaten sumedang,psikis,0,0,0,0,2018
264,kabupaten sumedang,seksual,1,1,0,2,2018
265,kabupaten sumedang,trafficking,0,0,0,0,2018
266,kabupaten indramayu,eksploitasi,0,0,0,0,2018
267,kabupaten indramayu,fisik,1,1,0,2,2018
268,kabupaten indramayu,lainnya,0,0,0,0,2018
269,kabupaten indramayu,penelantaran,0,1,0,1,2018
270,kabupaten indramayu,psikis,0,0,0,0,2018
271,kabupaten indramayu,seksual,1,4,0,5,2018
272,kabupaten indramayu,trafficking,0,0,0,0,2018
273,kabupaten subang,eksploitasi,0,0,0,0,2018
274,kabupaten subang,fisik,7,3,17,27,2018
275,kabupaten subang,lainnya,0,0,0,0,2018
276,kabupaten subang,penelantaran,0,1,0,1,2018
277,kabupaten subang,psikis,0,0,0,0,2018
278,kabupaten subang,seksual,8,30,7,45,2018
279,kabupaten subang,trafficking,0,0,6,6,2018
280,kabupaten purwakarta,eksploitasi,0,0,0,0,2018
281,kabupaten purwakarta,fisik,0,1,0,1,2018
282,kabupaten purwakarta,lainnya,0,0,0,0,2018
283,kabupaten purwakarta,penelantaran,0,1,0,1,2018
284,kabupaten purwakarta,psikis,2,0,0,2,2018
285,kabupaten purwakarta,seksual,1,4,0,5,2018
286,kabupaten purwakarta,trafficking,0,1,0,1,2018
287,kabupaten karawang,eksploitasi,0,0,0,0,2018
288,kabupaten karawang,fisik,1,3,0,4,2018
289,kabupaten karawang,lainnya,0,0,0,0,2018
290,kabupaten karawang,penelantaran,1,1,0,2,2018
291,kabupaten karawang,psikis,2,3,0,5,2018
292,kabupaten karawang,seksual,1,7,0,8,2018
293,kabupaten karawang,trafficking,0,0,0,0,2018
294,kabupaten bekasi,eksploitasi,0,0,0,0,2018
295,kabupaten bekasi,fisik,8,6,0,14,2018
296,kabupaten bekasi,lainnya,0,0,0,0,2018
297,kabupaten bekasi,penelantaran,0,0,0,0,2018
298,kabupaten bekasi,psikis,0,2,0,2,2018
299,kabupaten bekasi,seksual,4,17,0,21,2018
300,kabupaten bekasi,trafficking,0,0,0,0,2018
301,kabupaten bandung barat,eksploitasi,1,0,0,1,2018
302,kabupaten bandung barat,fisik,2,2,0,4,2018
303,kabupaten bandung barat,lainnya,0,0,0,0,2018
304,kabupaten bandung barat,penelantaran,0,0,1,1,2018
305,kabupaten bandung barat,psikis,0,2,0,2,2018
306,kabupaten bandung barat,seksual,4,7,0,11,2018
307,kabupaten bandung barat,trafficking,0,0,0,0,2018
308,kabupaten pangandaran,eksploitasi,0,1,0,1,2018
309,kabupaten pangandaran,fisik,0,0,0,0,2018
310,kabupaten pangandaran,lainnya,0,0,0,0,2018
311,kabupaten pangandaran,penelantaran,0,0,0,0,2018
312,kabupaten pangandaran,psikis,0,0,0,0,2018
313,kabupaten pangandaran,seksual,0,3,0,3,2018
314,kabupaten pangandaran,trafficking,0,0,0,0,2018
315,kota bogor,eksploitasi,0,0,0,0,2018
316,kota bogor,fisik,0,0,0,0,2018
317,kota bogor,lainnya,0,2,0,2,2018
318,kota bogor,penelantaran,0,0,2,2,2018
319,kota bogor,psikis,1,0,0,1,2018
320,kota bogor,seksual,6,8,0,14,2018
321,kota bogor,trafficking,0,0,0,0,2018
322,kota sukabumi,eksploitasi,0,0,0,0,2018
323,kota sukabumi,fisik,0,2,0,2,2018
324,kota sukabumi,lainnya,0,2,0,2,2018
325,kota sukabumi,penelantaran,2,3,0,5,2018
326,kota sukabumi,psikis,1,0,0,1,2018
327,kota sukabumi,seksual,5,3,0,8,2018
328,kota sukabumi,trafficking,0,0,0,0,2018
329,kota bandung,eksploitasi,0,0,0,0,2018
330,kota bandung,fisik,2,3,22,27,2018
331,kota bandung,lainnya,0,2,1,3,2018
332,kota bandung,penelantaran,1,1,12,14,2018
333,kota bandung,psikis,6,8,30,44,2018
334,kota bandung,seksual,5,14,5,24,2018
335,kota bandung,trafficking,0,1,0,1,2018
336,kota cirebon,eksploitasi,0,0,0,0,2018
337,kota cirebon,fisik,1,0,0,1,2018
338,kota cirebon,lainnya,0,0,0,0,2018
339,kota cirebon,penelantaran,0,0,0,0,2018
340,kota cirebon,psikis,2,0,0,2,2018
341,kota cirebon,seksual,5,0,0,5,2018
342,kota cirebon,trafficking,0,0,0,0,2018
343,kota bekasi,eksploitasi,0,0,0,0,2018
344,kota bekasi,fisik,1,0,2,3,2018
345,kota bekasi,lainnya,0,0,0,0,2018
346,kota bekasi,penelantaran,0,0,0,0,2018
347,kota bekasi,psikis,1,0,1,2,2018
348,kota bekasi,seksual,0,1,0,1,2018
349,kota bekasi,trafficking,0,0,0,0,2018
350,kota depok,eksploitasi,0,0,0,0,2018
351,kota depok,fisik,12,1,2,15,2018
352,kota depok,lainnya,0,0,0,0,2018
353,kota depok,penelantaran,1,0,0,1,2018
354,kota depok,psikis,2,1,1,4,2018
355,kota depok,seksual,3,25,0,28,2018
356,kota depok,trafficking,0,0,0,0,2018
357,kota cimahi,eksploitasi,0,1,0,1,2018
358,kota cimahi,fisik,4,1,0,5,2018
359,kota cimahi,lainnya,0,2,0,2,2018
360,kota cimahi,penelantaran,0,0,0,0,2018
361,kota cimahi,psikis,3,2,0,5,2018
362,kota cimahi,seksual,0,5,0,5,2018
363,kota cimahi,trafficking,0,1,0,1,2018
364,kota tasikmalaya,eksploitasi,0,0,0,0,2018
365,kota tasikmalaya,fisik,1,1,0,2,2018
366,kota tasikmalaya,lainnya,0,1,0,1,2018
367,kota tasikmalaya,penelantaran,0,0,0,0,2018
368,kota tasikmalaya,psikis,2,0,0,2,2018
369,kota tasikmalaya,seksual,1,3,0,4,2018
370,kota tasikmalaya,trafficking,0,0,0,0,2018
371,kota banjar,eksploitasi,0,0,0,0,2018
372,kota banjar,fisik,5,0,0,5,2018
373,kota banjar,lainnya,0,0,0,0,2018
374,kota banjar,penelantaran,0,1,0,1,2018
375,kota banjar,psikis,0,0,0,0,2018
376,kota banjar,seksual,1,6,0,7,2018
377,kota banjar,trafficking,0,0,0,0,2018
378,kabupaten bogor,eksploitasi,0,0,0,0,2019
379,kabupaten bogor,fisik,0,0,8,8,2019
380,kabupaten bogor,lainnya,1,1,2,4,2019
381,kabupaten bogor,penelantaran,0,0,1,1,2019
382,kabupaten bogor,psikis,0,0,4,4,2019
383,kabupaten bogor,seksual,0,1,0,1,2019
384,kabupaten bogor,trafficking,0,2,0,2,2019
385,kabupaten sukabumi,eksploitasi,0,0,0,0,2019
386,kabupaten sukabumi,fisik,2,4,14,20,2019
387,kabupaten sukabumi,lainnya,6,3,4,13,2019
388,kabupaten sukabumi,penelantaran,1,1,0,2,2019
389,kabupaten sukabumi,psikis,0,0,2,2,2019
390,kabupaten sukabumi,seksual,8,60,4,72,2019
391,kabupaten sukabumi,trafficking,0,0,27,27,2019
392,kabupaten cianjur,eksploitasi,0,0,0,0,2019
393,kabupaten cianjur,fisik,0,0,0,0,2019
394,kabupaten cianjur,lainnya,0,0,0,0,2019
395,kabupaten cianjur,penelantaran,0,0,0,0,2019
396,kabupaten cianjur,psikis,0,0,0,0,2019
397,kabupaten cianjur,seksual,0,3,0,3,2019
398,kabupaten cianjur,trafficking,0,0,0,0,2019
399,kabupaten bandung,eksploitasi,0,1,0,1,2019
400,kabupaten bandung,fisik,6,4,8,18,2019
401,kabupaten bandung,lainnya,22,9,2,33,2019
402,kabupaten bandung,penelantaran,0,2,3,5,2019
403,kabupaten bandung,psikis,1,5,8,14,2019
404,kabupaten bandung,seksual,2,22,7,31,2019
405,kabupaten bandung,trafficking,0,3,1,4,2019
406,kabupaten garut,eksploitasi,0,0,0,0,2019
407,kabupaten garut,fisik,0,2,4,6,2019
408,kabupaten garut,lainnya,0,1,0,1,2019
409,kabupaten garut,penelantaran,1,0,0,1,2019
410,kabupaten garut,psikis,1,1,4,6,2019
411,kabupaten garut,seksual,0,3,0,3,2019
412,kabupaten garut,trafficking,0,0,1,1,2019
413,kabupaten tasikmalaya,eksploitasi,0,0,0,0,2019
414,kabupaten tasikmalaya,fisik,0,0,0,0,2019
415,kabupaten tasikmalaya,lainnya,2,0,0,2,2019
416,kabupaten tasikmalaya,penelantaran,0,0,0,0,2019
417,kabupaten tasikmalaya,psikis,0,0,0,0,2019
418,kabupaten tasikmalaya,seksual,0,2,0,2,2019
419,kabupaten tasikmalaya,trafficking,0,0,0,0,2019
420,kabupaten ciamis,eksploitasi,0,1,0,1,2019
421,kabupaten ciamis,fisik,2,0,1,3,2019
422,kabupaten ciamis,lainnya,1,0,0,1,2019
423,kabupaten ciamis,penelantaran,0,0,0,0,2019
424,kabupaten ciamis,psikis,1,0,0,1,2019
425,kabupaten ciamis,seksual,0,0,0,0,2019
426,kabupaten ciamis,trafficking,0,0,0,0,2019
427,kabupaten kuningan,eksploitasi,0,0,0,0,2019
428,kabupaten kuningan,fisik,2,0,1,3,2019
429,kabupaten kuningan,lainnya,0,0,0,0,2019
430,kabupaten kuningan,penelantaran,0,0,0,0,2019
431,kabupaten kuningan,psikis,0,0,1,1,2019
432,kabupaten kuningan,seksual,0,0,0,0,2019
433,kabupaten kuningan,trafficking,0,0,0,0,2019
434,kabupaten cirebon,eksploitasi,0,0,1,1,2019
435,kabupaten cirebon,fisik,19,4,23,46,2019
436,kabupaten cirebon,lainnya,0,2,2,4,2019
437,kabupaten cirebon,penelantaran,1,0,1,2,2019
438,kabupaten cirebon,psikis,9,3,14,26,2019
439,kabupaten cirebon,seksual,14,15,3,32,2019
440,kabupaten cirebon,trafficking,0,0,0,0,2019
441,kabupaten majalengka,eksploitasi,0,0,0,0,2019
442,kabupaten majalengka,fisik,2,0,1,3,2019
443,kabupaten majalengka,lainnya,0,0,0,0,2019
444,kabupaten majalengka,penelantaran,0,0,0,0,2019
445,kabupaten majalengka,psikis,0,0,0,0,2019
446,kabupaten majalengka,seksual,3,10,0,13,2019
447,kabupaten majalengka,trafficking,0,0,0,0,2019
448,kabupaten sumedang,eksploitasi,0,0,0,0,2019
449,kabupaten sumedang,fisik,1,11,2,14,2019
450,kabupaten sumedang,lainnya,0,0,0,0,2019
451,kabupaten sumedang,penelantaran,0,0,0,0,2019
452,kabupaten sumedang,psikis,0,0,0,0,2019
453,kabupaten sumedang,seksual,0,2,0,2,2019
454,kabupaten sumedang,trafficking,0,0,0,0,2019
455,kabupaten indramayu,eksploitasi,0,0,0,0,2019
456,kabupaten indramayu,fisik,1,0,0,1,2019
457,kabupaten indramayu,lainnya,0,1,2,3,2019
458,kabupaten indramayu,penelantaran,4,0,1,5,2019
459,kabupaten indramayu,psikis,0,0,0,0,2019
460,kabupaten indramayu,seksual,0,16,0,16,2019
461,kabupaten indramayu,trafficking,0,0,1,1,2019
462,kabupaten subang,eksploitasi,0,0,0,0,2019
463,kabupaten subang,fisik,1,0,5,6,2019
464,kabupaten subang,lainnya,0,0,0,0,2019
465,kabupaten subang,penelantaran,0,0,1,1,2019
466,kabupaten subang,psikis,0,0,0,0,2019
467,kabupaten subang,seksual,0,4,4,8,2019
468,kabupaten subang,trafficking,0,1,1,2,2019
469,kabupaten purwakarta,eksploitasi,0,0,0,0,2019
470,kabupaten purwakarta,fisik,2,0,15,17,2019
471,kabupaten purwakarta,lainnya,0,0,0,0,2019
472,kabupaten purwakarta,penelantaran,0,0,0,0,2019
473,kabupaten purwakarta,psikis,0,0,0,0,2019
474,kabupaten purwakarta,seksual,0,12,0,12,2019
475,kabupaten purwakarta,trafficking,0,0,0,0,2019
476,kabupaten karawang,eksploitasi,0,0,0,0,2019
477,kabupaten karawang,fisik,0,0,1,1,2019
478,kabupaten karawang,lainnya,0,0,0,0,2019
479,kabupaten karawang,penelantaran,0,0,0,0,2019
480,kabupaten karawang,psikis,0,0,1,1,2019
481,kabupaten karawang,seksual,0,0,0,0,2019
482,kabupaten karawang,trafficking,0,0,0,0,2019
483,kabupaten bekasi,eksploitasi,0,0,0,0,2019
484,kabupaten bekasi,fisik,2,0,4,6,2019
485,kabupaten bekasi,lainnya,0,0,0,0,2019
486,kabupaten bekasi,penelantaran,0,0,1,1,2019
487,kabupaten bekasi,psikis,2,1,5,8,2019
488,kabupaten bekasi,seksual,1,0,1,2,2019
489,kabupaten bekasi,trafficking,0,0,0,0,2019
490,kabupaten bandung barat,eksploitasi,0,0,0,0,2019
491,kabupaten bandung barat,fisik,0,5,5,10,2019
492,kabupaten bandung barat,lainnya,1,0,1,2,2019
493,kabupaten bandung barat,penelantaran,0,1,1,2,2019
494,kabupaten bandung barat,psikis,0,2,7,9,2019
495,kabupaten bandung barat,seksual,1,8,0,9,2019
496,kabupaten bandung barat,trafficking,0,0,0,0,2019
497,kabupaten pangandaran,eksploitasi,0,0,0,0,2019
498,kabupaten pangandaran,fisik,4,0,0,4,2019
499,kabupaten pangandaran,lainnya,0,1,1,2,2019
500,kabupaten pangandaran,penelantaran,0,0,0,0,2019
501,kabupaten pangandaran,psikis,1,2,0,3,2019
502,kabupaten pangandaran,seksual,3,3,0,6,2019
503,kabupaten pangandaran,trafficking,0,0,0,0,2019
504,kota bogor,eksploitasi,0,0,0,0,2019
505,kota bogor,fisik,1,1,3,5,2019
506,kota bogor,lainnya,2,2,4,8,2019
507,kota bogor,penelantaran,1,3,4,8,2019
508,kota bogor,psikis,2,1,8,11,2019
509,kota bogor,seksual,0,4,2,6,2019
510,kota bogor,trafficking,0,0,0,0,2019
511,kota sukabumi,eksploitasi,0,0,0,0,2019
512,kota sukabumi,fisik,0,0,1,1,2019
513,kota sukabumi,lainnya,0,0,0,0,2019
514,kota sukabumi,penelantaran,0,0,0,0,2019
515,kota sukabumi,psikis,0,1,0,1,2019
516,kota sukabumi,seksual,0,2,0,2,2019
517,kota sukabumi,trafficking,0,0,1,1,2019
518,kota bandung,eksploitasi,1,1,0,2,2019
519,kota bandung,fisik,10,8,51,69,2019
520,kota bandung,lainnya,11,9,25,45,2019
521,kota bandung,penelantaran,5,7,28,40,2019
522,kota bandung,psikis,38,24,84,146,2019
523,kota bandung,seksual,63,37,12,112,2019
524,kota bandung,trafficking,0,1,1,2,2019
525,kota cirebon,eksploitasi,0,0,0,0,2019
526,kota cirebon,fisik,1,1,0,2,2019
527,kota cirebon,lainnya,0,0,0,0,2019
528,kota cirebon,penelantaran,0,0,1,1,2019
529,kota cirebon,psikis,1,0,0,1,2019
530,kota cirebon,seksual,2,1,0,3,2019
531,kota cirebon,trafficking,0,0,0,0,2019
532,kota bekasi,eksploitasi,0,0,0,0,2019
533,kota bekasi,fisik,0,1,0,1,2019
534,kota bekasi,lainnya,0,0,0,0,2019
535,kota bekasi,penelantaran,0,0,0,0,2019
536,kota bekasi,psikis,0,1,0,1,2019
537,kota bekasi,seksual,0,0,1,1,2019
538,kota bekasi,trafficking,0,0,0,0,2019
539,kota depok,eksploitasi,0,0,0,0,2019
540,kota depok,fisik,3,3,7,13,2019
541,kota depok,lainnya,2,2,7,11,2019
542,kota depok,penelantaran,0,0,0,0,2019
543,kota depok,psikis,2,4,8,14,2019
544,kota depok,seksual,1,10,3,14,2019
545,kota depok,trafficking,0,0,0,0,2019
546,kota cimahi,eksploitasi,0,0,0,0,2019
547,kota cimahi,fisik,0,1,2,3,2019
548,kota cimahi,lainnya,0,0,0,0,2019
549,kota cimahi,penelantaran,1,0,1,2,2019
550,kota cimahi,psikis,0,1,1,2,2019
551,kota cimahi,seksual,1,3,0,4,2019
552,kota cimahi,trafficking,0,0,1,1,2019
553,kota tasikmalaya,eksploitasi,0,0,0,0,2019
554,kota tasikmalaya,fisik,2,0,0,2,2019
555,kota tasikmalaya,lainnya,0,0,0,0,2019
556,kota tasikmalaya,penelantaran,0,0,0,0,2019
557,kota tasikmalaya,psikis,0,0,2,2,2019
558,kota tasikmalaya,seksual,2,0,0,2,2019
559,kota tasikmalaya,trafficking,0,0,0,0,2019
560,kota banjar,eksploitasi,0,0,0,0,2019
561,kota banjar,fisik,0,0,0,0,2019
562,kota banjar,lainnya,0,0,1,1,2019
563,kota banjar,penelantaran,0,0,0,0,2019
564,kota banjar,psikis,0,0,0,0,2019
565,kota banjar,seksual,0,0,0,0,2019
566,kota banjar,trafficking,0,0,0,0,2019
567,kabupaten bogor,eksploitasi,0,0,0,0,2020
568,kabupaten bogor,fisik,0,0,2,2,2020
569,kabupaten bogor,lainnya,0,0,0,0,2020
570,kabupaten bogor,penelantaran,0,0,0,0,2020
571,kabupaten bogor,psikis,0,1,0,1,2020
572,kabupaten bogor,seksual,0,0,1,1,2020
573,kabupaten bogor,trafficking,0,0,0,0,2020
574,kabupaten sukabumi,eksploitasi,0,0,0,0,2020
575,kabupaten sukabumi,fisik,0,0,1,1,2020
576,kabupaten sukabumi,lainnya,1,0,0,1,2020
577,kabupaten sukabumi,penelantaran,0,0,0,0,2020
578,kabupaten sukabumi,psikis,0,0,1,1,2020
579,kabupaten sukabumi,seksual,0,0,0,0,2020
580,kabupaten sukabumi,trafficking,0,0,0,0,2020
581,kabupaten cianjur,eksploitasi,0,0,1,1,2020
582,kabupaten cianjur,fisik,0,0,1,1,2020
583,kabupaten cianjur,lainnya,0,0,0,0,2020
584,kabupaten cianjur,penelantaran,0,0,0,0,2020
585,kabupaten cianjur,psikis,0,0,1,1,2020
586,kabupaten cianjur,seksual,0,0,1,1,2020
587,kabupaten cianjur,trafficking,0,0,0,0,2020
588,kabupaten bandung,eksploitasi,0,0,0,0,2020
589,kabupaten bandung,fisik,1,5,19,25,2020
590,kabupaten bandung,lainnya,15,9,8,32,2020
591,kabupaten bandung,penelantaran,1,4,7,12,2020
592,kabupaten bandung,psikis,4,9,19,32,2020
593,kabupaten bandung,seksual,6,25,10,41,2020
594,kabupaten bandung,trafficking,0,0,3,3,2020
595,kabupaten garut,eksploitasi,0,1,0,1,2020
596,kabupaten garut,fisik,0,0,2,2,2020
597,kabupaten garut,lainnya,0,0,1,1,2020
598,kabupaten garut,penelantaran,0,0,0,0,2020
599,kabupaten garut,psikis,0,0,3,3,2020
600,kabupaten garut,seksual,0,0,0,0,2020
601,kabupaten garut,trafficking,0,0,1,1,2020
602,kabupaten tasikmalaya,eksploitasi,0,0,0,0,2020
603,kabupaten tasikmalaya,fisik,4,1,0,5,2020
604,kabupaten tasikmalaya,lainnya,3,14,1,18,2020
605,kabupaten tasikmalaya,penelantaran,1,0,0,1,2020
606,kabupaten tasikmalaya,psikis,2,1,1,4,2020
607,kabupaten tasikmalaya,seksual,5,25,2,32,2020
608,kabupaten tasikmalaya,trafficking,0,1,0,1,2020
609,kabupaten ciamis,eksploitasi,0,0,0,0,2020
610,kabupaten ciamis,fisik,0,1,3,4,2020
611,kabupaten ciamis,lainnya,2,1,1,4,2020
612,kabupaten ciamis,penelantaran,0,0,0,0,2020
613,kabupaten ciamis,psikis,2,0,2,4,2020
614,kabupaten ciamis,seksual,1,11,0,12,2020
615,kabupaten ciamis,trafficking,0,0,0,0,2020
616,kabupaten kuningan,eksploitasi,0,0,0,0,2020
617,kabupaten kuningan,fisik,1,0,0,1,2020
618,kabupaten kuningan,lainnya,0,0,1,1,2020
619,kabupaten kuningan,penelantaran,1,0,0,1,2020
620,kabupaten kuningan,psikis,0,0,0,0,2020
621,kabupaten kuningan,seksual,4,5,0,9,2020
622,kabupaten kuningan,trafficking,0,0,0,0,2020
623,kabupaten cirebon,eksploitasi,0,0,0,0,2020
624,kabupaten cirebon,fisik,10,7,8,25,2020
625,kabupaten cirebon,lainnya,3,1,3,7,2020
626,kabupaten cirebon,penelantaran,0,0,1,1,2020
627,kabupaten cirebon,psikis,2,3,8,13,2020
628,kabupaten cirebon,seksual,3,18,1,22,2020
629,kabupaten cirebon,trafficking,0,1,0,1,2020
630,kabupaten majalengka,eksploitasi,0,0,0,0,2020
631,kabupaten majalengka,fisik,0,0,0,0,2020
632,kabupaten majalengka,lainnya,1,0,0,1,2020
633,kabupaten majalengka,penelantaran,0,0,0,0,2020
634,kabupaten majalengka,psikis,0,0,0,0,2020
635,kabupaten majalengka,seksual,0,1,0,1,2020
636,kabupaten majalengka,trafficking,0,0,0,0,2020
637,kabupaten sumedang,eksploitasi,0,0,0,0,2020
638,kabupaten sumedang,fisik,0,0,0,0,2020
639,kabupaten sumedang,lainnya,0,1,0,1,2020
640,kabupaten sumedang,penelantaran,0,0,0,0,2020
641,kabupaten sumedang,psikis,1,0,1,2,2020
642,kabupaten sumedang,seksual,0,0,0,0,2020
643,kabupaten sumedang,trafficking,0,0,0,0,2020
644,kabupaten indramayu,eksploitasi,0,0,0,0,2020
645,kabupaten indramayu,fisik,0,0,0,0,2020
646,kabupaten indramayu,lainnya,0,0,1,1,2020
647,kabupaten indramayu,penelantaran,0,0,0,0,2020
648,kabupaten indramayu,psikis,0,1,0,1,2020
649,kabupaten indramayu,seksual,0,0,0,0,2020
650,kabupaten indramayu,trafficking,0,0,0,0,2020
651,kabupaten subang,eksploitasi,0,0,0,0,2020
652,kabupaten subang,fisik,1,1,5,7,2020
653,kabupaten subang,lainnya,0,0,0,0,2020
654,kabupaten subang,penelantaran,0,0,0,0,2020
655,kabupaten subang,psikis,2,1,3,6,2020
656,kabupaten subang,seksual,3,10,1,14,2020
657,kabupaten subang,trafficking,0,1,1,2,2020
658,kabupaten purwakarta,eksploitasi,0,0,0,0,2020
659,kabupaten purwakarta,fisik,0,0,1,1,2020
660,kabupaten purwakarta,lainnya,0,0,0,0,2020
661,kabupaten purwakarta,penelantaran,0,0,0,0,2020
662,kabupaten purwakarta,psikis,0,0,1,1,2020
663,kabupaten purwakarta,seksual,0,0,0,0,2020
664,kabupaten purwakarta,trafficking,0,0,0,0,2020
665,kabupaten karawang,eksploitasi,0,0,0,0,2020
666,kabupaten karawang,fisik,0,0,0,0,2020
667,kabupaten karawang,lainnya,1,0,0,1,2020
668,kabupaten karawang,penelantaran,0,0,0,0,2020
669,kabupaten karawang,psikis,0,0,0,0,2020
670,kabupaten karawang,seksual,0,0,0,0,2020
671,kabupaten karawang,trafficking,0,0,0,0,2020
672,kabupaten bekasi,eksploitasi,0,0,0,0,2020
673,kabupaten bekasi,fisik,0,0,2,2,2020
674,kabupaten bekasi,lainnya,0,0,1,1,2020
675,kabupaten bekasi,penelantaran,0,0,0,0,2020
676,kabupaten bekasi,psikis,0,0,0,0,2020
677,kabupaten bekasi,seksual,0,0,0,0,2020
678,kabupaten bekasi,trafficking,0,0,0,0,2020
679,kabupaten bandung barat,eksploitasi,0,0,0,0,2020
680,kabupaten bandung barat,fisik,0,0,1,1,2020
681,kabupaten bandung barat,lainnya,0,1,0,1,2020
682,kabupaten bandung barat,penelantaran,0,0,0,0,2020
683,kabupaten bandung barat,psikis,0,0,2,2,2020
684,kabupaten bandung barat,seksual,0,1,2,3,2020
685,kabupaten bandung barat,trafficking,0,0,0,0,2020
686,kabupaten pangandaran,eksploitasi,0,0,0,0,2020
687,kabupaten pangandaran,fisik,0,1,0,1,2020
688,kabupaten pangandaran,lainnya,0,0,1,1,2020
689,kabupaten pangandaran,penelantaran,0,0,0,0,2020
690,kabupaten pangandaran,psikis,0,0,1,1,2020
691,kabupaten pangandaran,seksual,12,8,1,21,2020
692,kabupaten pangandaran,trafficking,0,0,0,0,2020
693,kota bogor,eksploitasi,0,0,0,0,2020
694,kota bogor,fisik,0,0,1,1,2020
695,kota bogor,lainnya,0,0,0,0,2020
696,kota bogor,penelantaran,0,0,0,0,2020
697,kota bogor,psikis,0,0,0,0,2020
698,kota bogor,seksual,0,1,0,1,2020
699,kota bogor,trafficking,0,0,0,0,2020
700,kota sukabumi,eksploitasi,0,0,0,0,2020
701,kota sukabumi,fisik,0,0,0,0,2020
702,kota sukabumi,lainnya,0,0,0,0,2020
703,kota sukabumi,penelantaran,0,0,0,0,2020
704,kota sukabumi,psikis,0,0,0,0,2020
705,kota sukabumi,seksual,0,0,0,0,2020
706,kota sukabumi,trafficking,0,0,0,0,2020
707,kota bandung,eksploitasi,2,1,0,3,2020
708,kota bandung,fisik,10,7,38,55,2020
709,kota bandung,lainnya,15,19,35,69,2020
710,kota bandung,penelantaran,3,7,16,26,2020
711,kota bandung,psikis,11,17,75,103,2020
712,kota bandung,seksual,14,34,5,53,2020
713,kota bandung,trafficking,0,0,0,0,2020
714,kota cirebon,eksploitasi,0,0,0,0,2020
715,kota cirebon,fisik,0,0,0,0,2020
716,kota cirebon,lainnya,0,0,0,0,2020
717,kota cirebon,penelantaran,0,0,0,0,2020
718,kota cirebon,psikis,0,0,0,0,2020
719,kota cirebon,seksual,0,0,0,0,2020
720,kota cirebon,trafficking,0,0,0,0,2020
721,kota bekasi,eksploitasi,0,0,0,0,2020
722,kota bekasi,fisik,0,1,1,2,2020
723,kota bekasi,lainnya,2,1,2,5,2020
724,kota bekasi,penelantaran,0,0,2,2,2020
725,kota bekasi,psikis,0,1,1,2,2020
726,kota bekasi,seksual,0,1,0,1,2020
727,kota bekasi,trafficking,0,0,0,0,2020
728,kota depok,eksploitasi,0,0,0,0,2020
729,kota depok,fisik,0,0,2,2,2020
730,kota depok,lainnya,0,0,1,1,2020
731,kota depok,penelantaran,0,0,0,0,2020
732,kota depok,psikis,0,0,3,3,2020
733,kota depok,seksual,0,2,2,4,2020
734,kota depok,trafficking,0,0,0,0,2020
735,kota cimahi,eksploitasi,0,0,0,0,2020
736,kota cimahi,fisik,0,0,1,1,2020
737,kota cimahi,lainnya,2,2,2,6,2020
738,kota cimahi,penelantaran,0,0,0,0,2020
739,kota cimahi,psikis,0,0,2,2,2020
740,kota cimahi,seksual,0,0,0,0,2020
741,kota cimahi,trafficking,0,0,0,0,2020
742,kota tasikmalaya,eksploitasi,0,0,0,0,2020
743,kota tasikmalaya,fisik,0,1,0,1,2020
744,kota tasikmalaya,lainnya,0,0,0,0,2020
745,kota tasikmalaya,penelantaran,0,0,0,0,2020
746,kota tasikmalaya,psikis,0,1,0,1,2020
747,kota tasikmalaya,seksual,0,0,0,0,2020
748,kota tasikmalaya,trafficking,0,0,0,0,2020
749,kota banjar,eksploitasi,0,0,0,0,2020
750,kota banjar,fisik,0,0,0,0,2020
751,kota banjar,lainnya,0,0,0,0,2020
752,kota banjar,penelantaran,0,0,1,1,2020
753,kota banjar,psikis,0,0,0,0,2020
754,kota banjar,seksual,4,0,0,4,2020
755,kota banjar,trafficking,0,0,0,0,2020
756,kabupaten bogor,eksploitasi,0,0,0,0,2021
757,kabupaten bogor,fisik,0,2,3,5,2021
758,kabupaten bogor,lainnya,1,0,4,5,2021
759,kabupaten bogor,penelantaran,1,4,2,7,2021
760,kabupaten bogor,psikis,0,2,3,5,2021
761,kabupaten bogor,seksual,0,3,1,4,2021
762,kabupaten bogor,trafficking,0,0,1,1,2021
763,kabupaten sukabumi,eksploitasi,0,0,0,0,2021
764,kabupaten sukabumi,fisik,0,1,0,1,2021
765,kabupaten sukabumi,lainnya,0,0,0,0,2021
766,kabupaten sukabumi,penelantaran,0,0,0,0,2021
767,kabupaten sukabumi,psikis,0,1,0,1,2021
768,kabupaten sukabumi,seksual,1,0,0,1,2021
769,kabupaten sukabumi,trafficking,0,0,0,0,2021
770,kabupaten cianjur,eksploitasi,0,0,0,0,2021
771,kabupaten cianjur,fisik,4,0,0,4,2021
772,kabupaten cianjur,lainnya,0,0,1,1,2021
773,kabupaten cianjur,penelantaran,0,0,0,0,2021
774,kabupaten cianjur,psikis,3,0,0,3,2021
775,kabupaten cianjur,seksual,1,0,0,1,2021
776,kabupaten cianjur,trafficking,0,0,0,0,2021
777,kabupaten bandung,eksploitasi,0,0,0,0,2021
778,kabupaten bandung,fisik,2,4,12,18,2021
779,kabupaten bandung,lainnya,3,4,4,11,2021
780,kabupaten bandung,penelantaran,0,2,6,8,2021
781,kabupaten bandung,psikis,2,2,14,18,2021
782,kabupaten bandung,seksual,3,3,2,8,2021
783,kabupaten bandung,trafficking,0,0,1,1,2021
784,kabupaten garut,eksploitasi,0,12,0,12,2021
785,kabupaten garut,fisik,1,3,4,8,2021
786,kabupaten garut,lainnya,1,2,1,4,2021
787,kabupaten garut,penelantaran,0,0,1,1,2021
788,kabupaten garut,psikis,0,13,6,19,2021
789,kabupaten garut,seksual,0,17,2,19,2021
790,kabupaten garut,trafficking,0,2,0,2,2021
791,kabupaten tasikmalaya,eksploitasi,0,1,0,1,2021
792,kabupaten tasikmalaya,fisik,6,5,9,20,2021
793,kabupaten tasikmalaya,lainnya,18,18,5,41,2021
794,kabupaten tasikmalaya,penelantaran,1,4,1,6,2021
795,kabupaten tasikmalaya,psikis,1,1,4,6,2021
796,kabupaten tasikmalaya,seksual,3,48,6,57,2021
797,kabupaten tasikmalaya,trafficking,0,2,0,2,2021
798,kabupaten ciamis,eksploitasi,0,0,0,0,2021
799,kabupaten ciamis,fisik,1,1,0,2,2021
800,kabupaten ciamis,lainnya,1,0,1,2,2021
801,kabupaten ciamis,penelantaran,0,0,0,0,2021
802,kabupaten ciamis,psikis,0,0,0,0,2021
803,kabupaten ciamis,seksual,3,11,0,14,2021
804,kabupaten ciamis,trafficking,0,0,0,0,2021
805,kabupaten kuningan,eksploitasi,0,0,0,0,2021
806,kabupaten kuningan,fisik,0,0,6,6,2021
807,kabupaten kuningan,lainnya,0,0,3,3,2021
808,kabupaten kuningan,penelantaran,2,0,1,3,2021
809,kabupaten kuningan,psikis,0,1,4,5,2021
810,kabupaten kuningan,seksual,1,3,1,5,2021
811,kabupaten kuningan,trafficking,0,0,1,1,2021
812,kabupaten cirebon,eksploitasi,0,0,4,4,2021
813,kabupaten cirebon,fisik,6,8,15,29,2021
814,kabupaten cirebon,lainnya,2,5,2,9,2021
815,kabupaten cirebon,penelantaran,0,3,26,29,2021
816,kabupaten cirebon,psikis,3,7,40,50,2021
817,kabupaten cirebon,seksual,13,25,16,54,2021
818,kabupaten cirebon,trafficking,0,1,7,8,2021
819,kabupaten majalengka,eksploitasi,0,0,0,0,2021
820,kabupaten majalengka,fisik,0,0,0,0,2021
821,kabupaten majalengka,lainnya,0,0,1,1,2021
822,kabupaten majalengka,penelantaran,0,0,0,0,2021
823,kabupaten majalengka,psikis,0,0,0,0,2021
824,kabupaten majalengka,seksual,0,0,0,0,2021
825,kabupaten majalengka,trafficking,0,0,4,4,2021
826,kabupaten sumedang,eksploitasi,0,0,0,0,2021
827,kabupaten sumedang,fisik,0,0,1,1,2021
828,kabupaten sumedang,lainnya,0,1,1,2,2021
829,kabupaten sumedang,penelantaran,0,0,1,1,2021
830,kabupaten sumedang,psikis,0,0,1,1,2021
831,kabupaten sumedang,seksual,0,0,0,0,2021
832,kabupaten sumedang,trafficking,0,0,0,0,2021
833,kabupaten indramayu,eksploitasi,0,0,0,0,2021
834,kabupaten indramayu,fisik,0,0,5,5,2021
835,kabupaten indramayu,lainnya,0,0,0,0,2021
836,kabupaten indramayu,penelantaran,0,0,1,1,2021
837,kabupaten indramayu,psikis,0,1,5,6,2021
838,kabupaten indramayu,seksual,0,1,2,3,2021
839,kabupaten indramayu,trafficking,0,1,6,7,2021
840,kabupaten subang,eksploitasi,0,0,0,0,2021
841,kabupaten subang,fisik,0,0,1,1,2021
842,kabupaten subang,lainnya,0,1,0,1,2021
843,kabupaten subang,penelantaran,0,0,0,0,2021
844,kabupaten subang,psikis,0,0,1,1,2021
845,kabupaten subang,seksual,0,0,0,0,2021
846,kabupaten subang,trafficking,0,0,3,3,2021
847,kabupaten purwakarta,eksploitasi,0,0,0,0,2021
848,kabupaten purwakarta,fisik,0,0,1,1,2021
849,kabupaten purwakarta,lainnya,0,0,0,0,2021
850,kabupaten purwakarta,penelantaran,0,0,0,0,2021
851,kabupaten purwakarta,psikis,0,0,1,1,2021
852,kabupaten purwakarta,seksual,0,0,0,0,2021
853,kabupaten purwakarta,trafficking,0,0,1,1,2021
854,kabupaten karawang,eksploitasi,0,0,0,0,2021
855,kabupaten karawang,fisik,0,0,2,2,2021
856,kabupaten karawang,lainnya,0,0,0,0,2021
857,kabupaten karawang,penelantaran,0,0,0,0,2021
858,kabupaten karawang,psikis,0,0,3,3,2021
859,kabupaten karawang,seksual,0,0,1,1,2021
860,kabupaten karawang,trafficking,0,1,0,1,2021
861,kabupaten bekasi,eksploitasi,0,0,0,0,2021
862,kabupaten bekasi,fisik,3,0,4,7,2021
863,kabupaten bekasi,lainnya,0,1,1,2,2021
864,kabupaten bekasi,penelantaran,0,0,0,0,2021
865,kabupaten bekasi,psikis,0,1,4,5,2021
866,kabupaten bekasi,seksual,0,2,0,2,2021
867,kabupaten bekasi,trafficking,0,0,0,0,2021
868,kabupaten bandung barat,eksploitasi,0,1,0,1,2021
869,kabupaten bandung barat,fisik,1,1,7,9,2021
870,kabupaten bandung barat,lainnya,2,0,1,3,2021
871,kabupaten bandung barat,penelantaran,0,1,3,4,2021
872,kabupaten bandung barat,psikis,1,3,7,11,2021
873,kabupaten bandung barat,seksual,0,1,1,2,2021
874,kabupaten bandung barat,trafficking,0,0,0,0,2021
875,kabupaten pangandaran,eksploitasi,0,0,0,0,2021
876,kabupaten pangandaran,fisik,2,1,2,5,2021
877,kabupaten pangandaran,lainnya,0,0,1,1,2021
878,kabupaten pangandaran,penelantaran,0,0,0,0,2021
879,kabupaten pangandaran,psikis,0,0,0,0,2021
880,kabupaten pangandaran,seksual,0,0,0,0,2021
881,kabupaten pangandaran,trafficking,0,0,0,0,2021
882,kota bogor,eksploitasi,0,0,0,0,2021
883,kota bogor,fisik,0,0,0,0,2021
884,kota bogor,lainnya,0,0,0,0,2021
885,kota bogor,penelantaran,0,0,0,0,2021
886,kota bogor,psikis,0,0,0,0,2021
887,kota bogor,seksual,0,0,0,0,2021
888,kota bogor,trafficking,0,0,0,0,2021
889,kota sukabumi,eksploitasi,0,0,0,0,2021
890,kota sukabumi,fisik,0,0,0,0,2021
891,kota sukabumi,lainnya,0,1,1,2,2021
892,kota sukabumi,penelantaran,0,0,0,0,2021
893,kota sukabumi,psikis,0,1,0,1,2021
894,kota sukabumi,seksual,0,0,0,0,2021
895,kota sukabumi,trafficking,0,0,0,0,2021
896,kota bandung,eksploitasi,0,6,1,7,2021
897,kota bandung,fisik,10,11,54,75,2021
898,kota bandung,lainnya,13,12,18,43,2021
899,kota bandung,penelantaran,4,3,24,31,2021
900,kota bandung,psikis,18,36,83,137,2021
901,kota bandung,seksual,5,54,17,76,2021
902,kota bandung,trafficking,0,2,4,6,2021
903,kota cirebon,eksploitasi,0,0,0,0,2021
904,kota cirebon,fisik,0,0,3,3,2021
905,kota cirebon,lainnya,1,0,2,3,2021
906,kota cirebon,penelantaran,0,0,3,3,2021
907,kota cirebon,psikis,0,0,7,7,2021
908,kota cirebon,seksual,0,1,1,2,2021
909,kota cirebon,trafficking,0,0,0,0,2021
910,kota bekasi,eksploitasi,0,0,0,0,2021
911,kota bekasi,fisik,0,2,5,7,2021
912,kota bekasi,lainnya,0,0,0,0,2021
913,kota bekasi,penelantaran,0,1,1,2,2021
914,kota bekasi,psikis,0,2,6,8,2021
915,kota bekasi,seksual,0,1,0,1,2021
916,kota bekasi,trafficking,0,3,1,4,2021
917,kota depok,eksploitasi,0,0,1,1,2021
918,kota depok,fisik,0,0,3,3,2021
919,kota depok,lainnya,1,0,0,1,2021
920,kota depok,penelantaran,0,0,0,0,2021
921,kota depok,psikis,1,0,1,2,2021
922,kota depok,seksual,0,0,2,2,2021
923,kota depok,trafficking,0,0,0,0,2021
924,kota cimahi,eksploitasi,0,2,0,2,2021
925,kota cimahi,fisik,0,0,1,1,2021
926,kota cimahi,lainnya,0,0,1,1,2021
927,kota cimahi,penelantaran,0,0,1,1,2021
928,kota cimahi,psikis,0,2,2,4,2021
929,kota cimahi,seksual,0,1,0,1,2021
930,kota cimahi,trafficking,0,0,0,0,2021
931,kota tasikmalaya,eksploitasi,0,0,0,0,2021
932,kota tasikmalaya,fisik,0,1,0,1,2021
933,kota tasikmalaya,lainnya,0,0,0,0,2021
934,kota tasikmalaya,penelantaran,0,0,0,0,2021
935,kota tasikmalaya,psikis,0,0,0,0,2021
936,kota tasikmalaya,seksual,0,0,1,1,2021
937,kota tasikmalaya,trafficking,0,0,0,0,2021
938,kota banjar,eksploitasi,0,0,0,0,2021
939,kota banjar,fisik,0,0,0,0,2021
940,kota banjar,lainnya,0,0,0,0,2021
941,kota banjar,penelantaran,0,0,0,0,2021
942,kota banjar,psikis,0,0,0,0,2021
943,kota banjar,seksual,0,2,0,2,2021
944,kota banjar,trafficking,0,0,0,0,2021
